11111111111111111111
10C00EPC0110001CC0C1
1CCC00C11CCC0100C001
1C11011C0100011001C1
1C01C0C0C00C11CC1101
101000110C000111C101
1C01C0110101001CC0C1
1CCCC1000000C11C0001
11010CCC11C001C10011
10CC0011C0110C11C001
1C101C00C11C000CC0C1
1C0110C10010C0000CC1
11CC0C1C101C0C0011C1
100C011C1000010C1C11
1C111001C1CC01C0C0C1
100C100010C00C01C011
1C1C10101C0000110001
1CC0C01CC0C0001111C1
1C0011CC00C00C0010C1
11111111111111111111
