111111111111111
100000000000101
100001000000101
100100000000011
100001011100101
100100010000001
100000001000001
10100000100E001
100000100100011
1000000000001P1
101000000000101
10000000001C001
100000000010001
101000010000011
111111111111111
