111111111111111111111111111111
100000000000000000000000001EC1
10000C00000000000000000001C101
100000000000000000000001010001
1000000000010000C0000000000001
1000000000000000000000000P0001
100000000C00000C00000000000001
100000000000000000000000000001
1000000000000000C0000C0000CC01
111111111111111111111111111111