111111111111111
1100C000E100001
110010001000001
1C0110000110001
100000100000001
1000000000001P1
110000000001011
100000010000001
100000C00010001
1000C0000000101
100000000100001
100100001000001
101011000000001
100C00010000001
111111111111111
