1111111111111111111111111
1000000000101000000000001
1C00000000000000000000001
1000000000000000000000001
10000000000000000E0000001
1001000000000000000001001
1000000000000000000000001
10C0000000000000000000001
1000000000000000000000001
1000000000000000000000001
100000P000000000000000001
1000000000000100000000001
1000000000000000000000001
1000000000000000000000001
1000000000000100000000001
1000000000000000000000001
1000000000000000000000001
1000000000000000000000001
1000000000010000000000001
1000000000000000000000001
1000000000000000000000001
1010000000000000100000001
1000000100000000000000001
1000000000000000000000001
1111111111111111111111111

