111111111111111111111111
100000000000000000000001
10E00000C000000000000001
1C0000111100000C00000001
10P000000000000000000001
100000011100000C00000001
111111111111111111111111