11111111111111111111111111111111111
10000000001000000000000100000000001
10000000000C0000000C000E00000000001
10000000000010000000000000100100001
10000000000000000000000000000000001
11000100001000010000000001000000001
1000000000000C000000000000000000001
1000000C0000C0000000000000110000001
1000000000100C000000000000001000001
10000000P00000000000010000000000001
10000000000000000000001000000000001
10000C0000000C000000100000000000001
11000000000000000000000000000000001
10000010000000000100000000000000001
11111111111111111111111111111111111