11111111111111111111
11000000100000100001
1001P101110001110001
10010000C00010000C01
11010000000001000001
10001010000010100C01
101000C0000000100011
10001000000000000001
10010010001C00000001
100100000000C0000011
100000000000000C0011
110001000010C0000001
1000001010000000C001
10010000010000000001
11000000C01101010011
1000000000010000E001
10001000000000000001
10000000010000000011
10000001000101000001
11111111111111111111