111111111111111111111111111111
11000100F100000010010000000101
10001010CCC0F00000010001000001
110100001000100000010010011001
10110010000000C000000001100001
101000010110F000C0000001010001
110000010110000000000000100101
1010001000C0C00C01000010001001
100110001000000000000000001001
100100C0CC01001010000010100011
10000100110F0000000011000P0101
110100000000000111000001010101
10C00CC00000100010000000000101
110010101001000010100011010001
101010000000000100C10100000011
10000000F000000111110001101001
100001000000010000000100010001
10C000110010110001011010000101
110000011100F00000000001000111
101000110010E10010C01010100001
100011010100FC0100010F0000F001
11C010001001000000000011000001
1010000F0001000001000101010101
101000C011001C100100001110F001
111111111111111111111111111111