11111111111111111111111111111111111111111111111111
1000100100000C00F1000000010011C01010C010011111C101
111010100010000010C0100111001100000110000P01110011
1001010000F1011100C1001001F01100000011100000F010C1
1101000C00010100000000100111111010000110000FEF0011
10000000011C100C1C010010111010100000C0100100F00001
101001100C001010F00101010C001000C10001100000100001
1110010010001000C10101010001010001101C001000001001
10100011111C00010001001C0F0CC00F1101110C01001010C1
1000000F10011100111000011001101000F111100000000001
10101000000101000001100C0110000C10000000C101011101
100010110011000010F100000F100010101100000010010101
100C10C1001101000010001101001101000010C01001000011
101011F110011000F000000000001010100011101100C10101
11111111111111111111111111111111111111111111111111